99 99 99 99 99 99 99 99 99 99 99 99 99 99 99 99 99 99 99 99 99 99 99 99 99 99 99 99 99 99 99 99
99 99 99 99 99 99 99 99 99 99 99 99 99 99 99 99 99 99 99 99 99 99 99 99 99 99 99 99 99 99 99 99
99 99 99 99 99 99 99 99 99 99 99 99 99 99 99 99 99 99 99 99 99 99 99 99 99 99 99 99 99 99 99 99
99 99 99 99 99 99 99 99 99 99 99 99 99 99 99 99 99 99 99 99 99 99 99 99 99 99 99 99 99 99 99 99
99 99 99 99 51 05 05 05 05 31 05 05 05 05 05 05 05 05 05 05 05 05 05 05 05 05 05 50 99 99 99 99
99 99 99 99 19 54 54 00 00 19 00 00 00 00 00 00 00 00 00 00 00 00 00 00 00 00 00 19 99 99 99 99
99 99 99 99 19 54 54 00 00 13 00 00 51 05 52 00 00 00 00 00 00 00 00 00 00 00 00 19 99 99 99 99
99 99 99 99 30 05 52 00 00 00 00 00 19 00 00 00 00 00 00 51 50 00 00 00 51 52 54 19 99 99 99 99
99 99 99 99 19 54 00 00 00 00 00 00 13 00 00 39 00 00 00 38 37 00 00 00 19 54 54 19 99 99 99 99
99 99 99 99 30 05 05 50 00 00 00 00 00 00 00 19 00 00 00 00 00 00 00 00 38 05 05 32 99 99 99 99
99 99 99 99 19 00 00 13 00 39 00 00 00 00 00 30 52 00 00 00 00 00 00 00 00 00 00 19 99 99 99 99
99 99 99 99 19 00 00 00 00 30 50 00 00 00 51 32 54 00 00 51 05 50 00 00 00 00 00 19 99 99 99 99
99 99 99 99 19 00 00 00 00 30 37 00 00 00 38 32 54 00 00 38 05 37 00 00 00 00 00 19 99 99 99 99
99 99 99 99 19 00 00 39 00 13 00 00 00 00 00 30 52 00 00 00 00 00 00 00 00 00 00 19 99 99 99 99
99 99 99 99 30 05 05 37 00 00 00 00 00 00 00 19 00 00 00 00 00 00 00 00 51 05 05 32 99 99 99 99
99 99 99 99 19 54 00 00 00 00 00 00 39 00 00 13 00 00 00 51 50 00 00 00 19 54 54 19 99 99 99 99
99 99 99 99 30 05 52 00 00 00 00 00 19 00 00 00 00 00 00 38 37 00 00 00 38 52 54 19 99 99 99 99
99 99 99 99 19 54 54 00 00 39 00 00 38 05 52 00 00 00 00 00 00 00 00 00 00 00 00 19 99 99 99 99
99 99 99 99 19 54 54 00 00 19 00 00 00 00 00 00 00 00 00 00 00 00 00 00 00 00 00 19 99 99 99 99
99 99 99 99 38 05 05 05 05 33 05 05 05 05 05 05 05 05 05 05 05 05 05 05 05 05 05 37 99 99 99 99
99 99 99 99 99 99 99 99 99 99 99 99 99 99 99 99 99 99 99 99 99 99 99 99 99 99 99 99 99 99 99 99
99 99 99 99 99 99 99 99 99 99 99 99 99 99 99 99 99 99 99 99 99 99 99 99 99 99 99 99 99 99 99 99
99 99 99 99 99 99 99 99 99 99 99 99 99 99 99 99 99 99 99 99 99 99 99 99 99 99 99 99 99 99 99 99
99 99 99 99 99 99 99 99 99 99 99 99 99 99 99 99 99 99 99 99 99 99 99 99 99 99 99 99 99 99 99 99